{
   "heights": [
      [12, 12, 12, 10, 10, 15, 15, 17, 17, 17, 18, 18, 18, 18],
      [12, 12, 12, 10, 10, 15, 15, 17, 17, 17, 18, 18, 18, 18],
      [ 7,  7, 11, 10, 10, 15, 15, 12, 12, 12, 15, 15, 18, 18],
      [ 7,  7,  9, 10, 10, 10, 14, 12, 12, 12, 13, 13, 13, 13],
      [ 6,  7,  8,  9, 10, 10, 10, 10, 11, 12, 12, 13, 13, 13],
      [ 6,  7,  8,  9, 10, 10, 10, 10, 10, 10, 10, 15, 15, 15],
      [ 6,  6, 11, 11, 11, 10, 10, 10, 10, 10, 10, 15, 15, 15]
   ],
   "walkable": [
      [ 1,  1,  1,  1,  1,  1,  1,  1,  1,  1,  1,  1,  1,  1],
      [ 1,  1,  1,  1,  1,  1,  1,  1,  1,  1,  1,  1,  1,  1],
      [ 1,  1,  1,  1,  1,  1,  1,  1,  1,  1,  1,  1,  1,  1],
      [ 1,  1,  1,  1,  1,  1,  1,  1,  1,  1,  1,  1,  1,  1],
      [ 1,  1,  1,  1,  1,  1,  1,  1,  1,  1,  1,  1,  1,  1],
      [ 1,  1,  1,  1,  1,  1,  1,  1,  1,  1,  1,  1,  1,  1],
      [ 1,  1,  1,  1,  1,  1,  1,  1,  1,  1,  1,  1,  1,  1]
   ]
}